NO images/face.xpm
SO images/11.xpm
WE images/111.xpm
EA images/weapon/weapon1.xpm

C 26,59,183
F 26,59,30

   1111111
   1S000011111
   100000000001   1
    101100000001  1
    101100010001  1
   101100000001   1
   10110000011    1
   1111111111
         101
         111