NO images/wall_ea.xpm
SO images/wall_no.xpm
WE images/wall_so.xpm
EA images/wall_we.xpm

C 26,59,183
F 26,59,30

11111111111
1W010000001 
10000000001 
10000010001 
10010010001 
10000000001
11111111111
