NO ./bg_test.xpm
     SO ./bg_test.xpm
WE      ./bg_test.xpm
EA ./bg_test.xpm

C 225,30,0
F 220,100,0

11111111111
10010000001 
10000000001 
1E000010001 
10010010001 
10000000001
11111111111