NO images/wall_ea.xpm
SO images/wall_no.xpm
WE images/wall_so.xpm
EA images/wall_we.xpm

C 26,59,183
F 26,59,30

111111
1N00001
10000001111
111001111
11111111