     NO ./11.xpm
SO        ./bg_test.xpm
WE    ./005.xpm
EA ./26.xpm

C 26,59,183
F 26,59,30

111111
1E00001
10000001111
111001111
11111111