NO ./bg_test.xpm
SO ./bg_test.xpm
WE ./bg_test.xpm
EA ./bg_test.xpm

C 225,30,0
F 220,100,0
111111111
101010111111 1 1 1
1111 10000N1 1 
11111111111