     NO ./11.xpm
SO        ./bg_test.xpm
WE    ./005.xpm
EA ./26.xpm

C 26,59,183
F 26,59,30

11111111111
10010000001 
10000N00001 
10000010001 
10010010001 
10000000001
11111111111