NO images/rabia.xpm
SO images/turk.xpm
WE images/logo.xpm
EA images/adam.xpm

C 26,59,183
F 26,59,30

111111
1S000011111
100000000001
101100000001
101100010001
101100000001
10110000011
1111111111
101
111