NO images/face.xpm
SO images/11.xpm
WE images/111.xpm
EA images/weapon/weapon1.xpm

C 26,59,183
F 26,59,30

   1111111
   1S000011111
   1000000000011111
    101100000001111
    101100010001  
   101100000001   
   10110000011    
   1111111111
         101
         111
         1
         1
         1
         1
         1
         1
         1
         1
         1
         1
         1
         1
         1
         1
         1
         1
         1
         1
         1
         1
         1
         1
         1
         1
         1
         1
         1
         1
