NO images/wall_ea.xpm
SO images/wall_no.xpm
WE images/wall_so.xpm
EA images/wall_we.xpm
C 26,59,183
F 26,59,30

   1C11111
   10000011CC1
   100000000001
   100000000001
   100000000001
   1000000000101
   1000000000011
   1C000C000000C1
   1000000000011
   10000N000001
   100000000001
   1000000001001
   C0000000000C1
   1001000000001
   100000000001
   10000000000C
   100000000001
   100000000001
   11C1111111C1