NO images/wall_ea.xpm
SO images/wall_no.xpm
WE images/wall_so.xpm
EA images/wall_we.xpm
C 26,59,183
F 26,59,30

111111111111111
   101111110001
   10000011C1C1
   100000000001
   100000000001
   100000000001
   1000000000101
   10000000000111
   100000000000C01
   10000000000111
   10000N000001
   100000000001
   10000000010011
   100000000000C01
   10010000000011
   100000000001
   100000000001
   100000000001
   100000000001
   111111111111