NO images/wall_ea.xpm
SO images/wall_no.xpm
WE images/wall_so.xpm
EA images/wall_we.xpm

C 26,59,183
F 26,59,30

111111111111111111111111111111111111111111111111111111111111111111111111111111111111111111111111111111111111
1W000000000000000000000000000000000000000000000000000000000000000000000000000000000000000000001 
10000000000000000000000000000000000000000000000000000000000000000000000000000000000000000000001 
10000000000000000000000000000000000000000000000000000000000000000000000000000000000000000000001 
10000000000000000000000000000000000000000000000000000000000000000000000000000000000000000000001 
10000000000000000000000000000000000000000000000000000000000000000000000000000000000000000000001
10000000000000000000000000000000000000000000000000000000000000000000000000000000000000000000001 
10000000000000000000000000000000000000000000000000000000000000000000000000000000000000000000001 
10000000000000000000000000000000000000000000000000000000000000000000000000000000000000000000001 
10000000000000000000000000000000000000000000000000000000000000000000000000000000000000000000001
10000000000000000000000000000000000000000000000000000000000000000000000000000000000000000000001 
10000000000000000000000000000000000000000000000000000000000000000000000000000000000000000000001 
10000000000000000000000000000000000000000000000000000000000000000000000000000000000000000000001 
10000000000000000000000000000000000000000000000000000000000000000000000000000000000000000000001
10000000000000000000000000000000000000000000000000000000000000000000000000000000000000000000001 
10000000000000000000000000000000000000000000000000000000000000000000000000000000000000000000001 
10000000000000000000000000000000000000000000000000000000000000000000000000000000000000000000001 
10000000000000000000000000000000000000000000000000000000000000000000000000000000000000000000001
10000000000000000000000000000000000000000000000000000000000000000000000000000000000000000000001 
10000000000000000000000000000000000000000000000000000000000000000000000000000000000000000000001 
10000000000000000000000000000000000000000000000000000000000000000000000000000000000000000000001 
10000000000000000000000000000000000000000000000000000000000000000000000000000000000000000000001
10000000000000000000000000000000000000000000000000000000000000000000000000000000000000000000001 
10000000000000000000000000000000000000000000000000000000000000000000000000000000000000000000001 
10000000000000000000000000000000000000000000000000000000000000000000000000000000000000000000001 
10000000000000000000000000000000000000000000000000000000000000000000000000000000000000000000001
10000000000000000000000000000000000000000000000000000000000000000000000000000000000000000000001 
10000000000000000000000000000000000000000000000000000000000000000000000000000000000000000000001 
10000000000000000000000000000000000000000000000000000000000000000000000000000000000000000000001 
10000000000000000000000000000000000000000000000000000000000000000000000000000000000000000000001
10000000000000000000000000000000000000000000000000000000000000000000000000000000000000000000001 
10000000000000000000000000000000000000000000000000000000000000000000000000000000000000000000001 
10000000000000000000000000000000000000000000000000000000000000000000000000000000000000000000001 
10000000000000000000000000000000000000000000000000000000000000000000000000V00000000000000000001
111111111111111111111111111111111111111111111111111111111111111111111111111111111111111111111111111
