N images/wall_ea.xpm
S images/wall_no.xpm
W images/wall_so.xpm
E images/wall_we.xpm
CE 10,10,200
FL 26,59,30

111
1111111111111
111000010000011111
   100000000001
   1000100000001
   100000000001
   100000100001111
1111000V000000C01
100000100000111111
110000000001111
 111100000000001
100010000V01111
 11100000000001
   100000000001
   10000N000001
   100000000001
   100000000001
   100000000001
   100000000001
   111111111111