NO images/wall_ea.xpm
SO images/wall_no.xpm
WE images/wall_so.xpm
EA images/wall_we.xpm
C 10,10,200
F 26,59,30

1111111111
   10000011111
   100000000001
   100000000001
   100000000001
   10000010000111
   10000000000001
   10000000000111
   100000000001
   100000000001
   100010001001
   100000000001
   100000000001
   10000N000001
   10001C100001
   100000000001
   100000000001
   100000000001
   111111111111