NO images/wall_ea.xpm
SO images/wall_no.xpm
WE images/wall_so.xpm
EA images/wall_we.xpm
C 26,59,183
F 26,59,30

   1111111
   10000011111
   100000000001
   100000000001
   100000000001
   100000000001
   100000000001
   100000000001
   100000000001
   10000N000001
   100000000001
   100000000001
   100000000001
   100000000001
   100000000001
   100000000001
   100000000001
   100000000001
   111111111111