N images/wall_ea.xpm
S images/wall_no.xpm
W images/wall_so.xpm
E images/wall_we.xpm
CE 10,10,200
FL 26,59,30
111
1111111111111
111000010000011111
   100000000001
   10V0000V0001
   100000000001
   100000100001111
11110000000000C01
10000000000111111
1100000000001111
 111100000000001
10001C101001111
 11100000000001
   10V000000001
   10000N000001
   10001C100001
   100000000001
   100000000001
   100000000001
   111111111111