NO images/rabia.xpm
SO images/turk.xpm
WE images/logo.xpm
EA images/adam.xpm

C 26,59,183
F 26,59,30

1111
10N1
1111